ajsthen=
then((resposta) => {
})

aclog= console.log()

algoCopiado + aclogv = console.log('resposta', resposta)

algoCopiado + aPrintv = print('resposta', resposta)

aJsAf ou aafjs= () => {}

aCyEq = expect(valor).to.equal()

aCyDEq= expect(valor).to.deep.equal()

aCySh= should('', '')

acyit= it('descricao_do_teste', () => {
})

aDjMMig= python manage.py makemigrations

adjmig= python manage.py migrate

aDjRServer= python manage.py runserver

aCySheq= should('to.equal', )

aCyShdeq = should('to.deep.equal', )

aCyReq aCyRequest= cy.request({
method: '',
url: '',
headers: {
Authorization: token},})

NOVO
cy.request({
method: '',
url: '',
auth: {
bearer: token},})

aCyDesc= describe('descricao_do_describe', function() {
})

ajsthenf ou acythen= then(function(resposta) {
})

acybefore= before(function() {
})

acyafter= after(function() {
})

aCyBEach= beforeEach(function() {
})

aCyAEach= afterEach(function() {
})